L=4
...............
...............
...............
...............
....f....pf....
....p..........
.......p.......
......psp......
.......p.......
..........p....
....fp....f....
...............
...............
...............
...............
