I=35
L=1
.....................
.sp...............pc.
...................p.
.....................
.cp............pc....
.p..............p....
.....................
....cp......pc.......
....p........p.......
.....................
.........pf..........
.....................
.......p.....p.......
.......cp...pc.......
.....................
....p...........p....
....cp.........pc....
.....................
.p.................p.
.cp...............pc.
.....................
