........
.S......
........
........
......F.
